1111111111111111111111111111111111
1000011100000100000100000100000001
1020011001000000100000100000100001
1000010001000111111111111000110001
1100111111001000000101101000110001
1000000000001000000100001000011001
1000000000001001100100111110001111
1001111111111001000100000000000001
1001100000000001000100000011110001
1000000000000001000100000010010001
1000000111111111000100000010000001
1111111111000000000100110011111111
1000000000000000000100010000000001
1000001110000011111111001111100001
1001111000000110000001110000010001
1001100111100100000000000010001001
1000000100000100010011111110001111
1111111001111100010001000011110001
1000000000000000010000011000000001
1111111111111111111111111111111111
