111111111111111111
100000000000000001
100000000020000001
100000000000000001
100000000000000001
100000111000001111
100000100000000001
100000100000000001
100000111000001111
100000000000000001
100000000000000001
100000111000000001
100000111000000001
100000111000000001
100000000000000001
111111000001111111
100000000000000001
111111111111111111
