11111111111
10000000001
10010002001
10000000001
10000000111
10000000001
10000000001
10000000001
10000100001
10000100001
11111111111
