11111111111
10000000001
10000002001
10000000001
10001111111
10000100001
11000100001
10000000001
10000000001
10000000001
11111111111
