1111111111111
1000000000001
1001001001001
1000100010001
1000000000001
1111111111111
